6 6 10 50
0 0 0 0 0 0
0 1 1 1 1 0
1 1 1 1 1 1
1 1 1 1 1 1
0 1 1 1 1 0
0 0 0 0 0 0